1011111011
0200111011
0011100000
0010110100
0010100000
0000001011
0011101000
0010000100
0000110000
1111011111
