1111111011
1200111011
1011100011
1010110111
1010100000
1000001011
1011101001
1010000101
1000110001
1111011111
